#################
#############....
#############.###
#############.###
#############.###
###########.....#
###########.###.#
..######....###.#
#.######.######.#
#.###....######..
#.###.###########
#.....###########
###.#############
###.#############
###.#############
....#############
#################
