#################
#################
#################
....#######.....#
###.#######.###.#
#...#######.###..
#.#########.#####
#........##.#####
#####.#...#.#####
#####.##........#
#####.#########.#
..###.#######...#
#.###.#######.###
#.....#######....
#################
#################
#################
