#################
#########.......#
#########.#####.#
#######...#####.#
#######.#######.#
###.....#######.#
###.#.#########.#
#...#....######..
#.######.######.#
..######....#...#
#.#########.#.###
#.#######.....###
#.#######.#######
#.#####...#######
#.#####.#########
#.......#########
#################
