#################
#############...#
#############.#.#
###########...#.#
###########.###.#
###########.###.#
###########.###.#
#####.......###..
#####.#...#.#####
..###.......#####
#.###.###########
#.###.###########
#.###.###########
#.#...###########
#.#.#############
#...#############
#################
