#################
#############....
#############.#.#
#############.#.#
#############.#.#
###########...#.#
###########.###.#
########........#
########.########
#........########
#.###.###########
#.#...###########
#.#.#############
#.#.#############
#.#.#############
....#############
#################
