#################
#############....
#############.###
....#########.###
###.#########.###
###.#########.###
###.#########.###
###.####......###
###.####.####.###
###......####.###
###.#########.###
###.#########.###
###.#########.###
###.#########....
###.#############
....#############
#################
