#################
#################
#################
#################
#################
#######.........#
#######.#.###.#.#
..#####.#.###...#
#.#####...#####.#
#...###.#.#####..
#.#.###.#.#######
#.........#######
#################
#################
#################
#################
#################
