#################
#########........
#########.###.#.#
#########.###...#
#########.###.###
#########.###.###
#########.###.###
#####.....#...###
#####.##.##.#####
###...#.....#####
###.###.#########
###.###.#########
###.###.#########
#...###.#########
#.#.###.#########
........#########
#################
