#################
......###########
#.#.#.###########
#.......#########
#######.#########
#######...#######
#########.#######
########..#######
########.########
#######..########
#######.#########
#######...#######
#########.#######
#########.......#
###########.#.#.#
###########......
#################
