#################
..###############
#.###############
#.....###########
#.###.###########
#.###...#########
#.###.#.#########
#...........#####
#####.##.##.#####
#####...........#
#########.#.###.#
#########...###.#
###########.###.#
###########.....#
###############.#
###############..
#################
