#################
..###############
#.###############
#.###############
#.###############
#...#############
#.#.#############
#...#...........#
#.#.#.#...#.#.#.#
#...........#...#
#############.#.#
#############...#
###############.#
###############.#
###############.#
###############..
#################
