#################
###########.....#
###########.###.#
###########.###..
###########.#####
#########...###..
#########.#####.#
#...#...#.#...#.#
#.#.#.#...#.#.#.#
#.#...#.#...#...#
#.#####.#########
..###...#########
#####.###########
..###.###########
#.###.###########
#.....###########
#################
