#################
#################
#################
#################
#################
..#########.....#
#.#########.#.#.#
#.######....#...#
#.######.######.#
#...#....######.#
#.#.#.#########.#
#.....#########..
#################
#################
#################
#################
#################
